// map_file_com.txt 12Nov2020  crs, from map_file.txt
// Map file with // comments
    #####################   // Top wall
    #...#...............#
    #...#..........#....#
    #...#..........#....#
    #...#..........#....#
    #...#..........#....#
    #..............#....#
    #..............#....#
    #####################   // Bottom wall

